12 12 12 12 12 12 12 12 12 12 12 12 12 12 12 12 12 12 12 12 12 12 12 12 12 12 12 12 12 12 12 12 12 12 12 12 12 12 12 12 12 12 12 12 12 12 12 12 12 12
12 12 12 12 12 12 12 12 12 12 12 12 12 12 12 12 12 12 12 12 12 12 12 12 12 12 12 12 12 12 12 12 12 12 12 12 12 12 12 12 12 12 12 12 12 12 12 12 12 12
12 12 12 12 12 12 12 12 12 12 12 12 12 12 12 12 12 12 12 12 12 12 12 12 12 12 12 12 12 12 12 12 12 12 12 12 12 12 12 12 12 12 12 12 12 12 12 12 12 12
12 12 12 12 12 12 12 12 12 12 12 12 12 12 12 12 12 12 12 12 12 12 12 12 12 12 12 12 12 12 12 12 12 12 12 12 12 12 12 12 12 12 12 12 12 12 12 12 12 12
12 12 12 12 12 12 12 12 12 12 12 12 12 12 12 12 12 12 12 12 12 12 12 12 12 12 12 12 12 12 12 12 12 12 12 12 12 12 12 12 12 12 12 12 12 12 12 12 12 12
12 12 12 12 12 12 12 12 12 12 12 12 12 12 12 12 12 12 12 12 12 12 12 12 12 12 12 12 12 12 12 12 12 12 12 12 12 12 12 12 12 12 12 12 12 12 12 12 12 12
12 12 12 12 12 12 12 12 23 20 20 20 20 20 20 20 20 20 22 12 12 12 12 23 20 20 20 20 20 20 20 20 22 12 12 12 23 20 20 22 12 12 12 12 12 12 12 12 12 12
12 12 12 12 12 12 12 12 18 11 11 11 11 11 11 11 11 11 19 20 20 20 20 21 11 11 11 11 11 11 26 26 19 20 20 20 21 26 11 19 22 12 12 12 12 12 12 12 12 12
12 12 12 12 12 12 12 12 18 11 11 11 11 11 11 11 11 11 11 11 11 11 26 11 14 15 15 15 16 11 26 26 26 11 11 11 11 11 11 11 17 12 12 12 12 12 12 12 12 12
12 12 12 12 12 12 12 12 18 11 11 11 11 11 11 11 11 11 11 11 11 11 26 11 17 12 12 12 18 11 26 26 11 11 11 11 11 11 11 11 17 12 12 12 12 12 12 12 12 12
12 12 12 12 12 12 12 12 18 11 11 11 11 27 27 27 27 27 11 11 11 11 26 11 17 12 12 12 18 11 26 26 11 11 11 11 11 11 11 11 17 12 12 12 12 12 12 12 12 12
12 12 12 12 12 12 12 12 18 11 11 11 11 27 28 28 28 27 11 11 11 11 26 11 19 20 20 20 21 11 26 26 11 11 11 11 11 11 11 11 19 22 12 12 12 12 12 12 12 12
12 12 12 12 12 12 12 12 25 16 11 11 11 27 28 28 28 27 11 11 11 11 26 11 11 11 11 11 11 11 26 26 11 11 11 11 11 11 11 11 11 17 12 12 12 12 12 12 12 12
12 12 12 12 12 12 12 12 12 18 11 11 11 27 28 28 28 27 11 11 11 11 26 11 11 11 11 11 11 11 26 26 11 11 11 11 11 11 11 11 11 17 12 12 12 12 12 12 12 12
12 12 12 12 12 12 12 12 12 18 11 11 11 27 28 28 28 27 11 11 11 11 11 26 11 11 11 11 11 26 26 26 26 11 11 11 11 11 11 11 11 17 12 12 12 12 12 12 12 12
12 12 12 12 12 12 12 12 12 18 11 11 11 27 27 28 27 27 11 11 11 11 11 26 26 11 11 11 26 26 26 11 26 26 26 26 26 26 11 11 11 17 12 12 12 12 12 12 12 12
12 12 12 12 12 12 12 12 12 18 11 11 11 11 11 11 11 11 11 11 11 11 11 26 26 11 11 11 26 26 26 11 11 11 11 11 11 26 11 11 11 17 12 12 12 12 12 12 12 12
12 12 12 12 12 12 12 12 23 21 11 11 11 11 11 11 11 11 11 11 11 11 11 26 26 11 11 11 26 26 26 11 11 11 11 11 11 26 11 11 11 17 12 12 12 12 12 12 12 12
12 12 12 12 12 12 12 12 18 11 11 11 11 11 26 26 26 26 26 26 26 26 26 26 11 11 11 11 11 26 26 26 26 26 26 26 26 11 11 11 11 17 12 12 12 12 12 12 12 12
12 12 12 12 12 12 12 12 18 11 11 11 11 26 26 26 26 26 26 11 11 11 11 11 11 11 11 11 11 11 11 11 11 11 11 11 11 11 11 11 26 17 12 12 12 12 12 12 12 12
12 12 12 12 12 12 12 12 18 11 11 11 11 26 26 26 26 26 26 11 11 11 11 11 11 11 11 11 11 11 11 11 11 11 11 11 11 11 11 11 14 24 12 12 12 12 12 12 12 12
12 12 12 12 12 12 12 12 18 11 11 11 11 26 26 26 26 26 26 11 11 11 11 11 11 11 11 11 11 11 11 11 11 11 11 11 11 11 11 11 17 12 12 12 12 12 12 12 12 12
12 12 12 12 12 12 12 12 18 11 11 11 11 26 26 26 26 26 26 11 11 11 26 26 11 11 11 11 11 26 26 26 26 26 26 26 26 11 11 11 17 12 12 12 12 12 12 12 12 12
12 12 12 12 12 12 12 12 18 11 11 11 11 26 26 11 11 11 11 11 11 11 11 26 26 11 11 11 26 26 11 11 11 11 11 11 26 11 11 11 17 12 12 12 12 12 12 12 12 12
12 12 12 12 12 12 12 12 18 11 11 11 11 26 26 11 11 11 11 11 11 11 11 11 11 11 11 11 26 11 11 11 11 11 11 11 26 11 11 11 17 12 12 12 12 12 12 12 12 12
12 12 12 12 12 12 12 12 18 11 11 11 11 26 26 11 11 11 11 11 11 11 11 11 11 11 11 11 26 11 11 11 11 11 11 11 26 11 11 11 17 12 12 12 12 12 12 12 12 12
12 12 12 12 12 12 12 12 18 11 11 11 11 11 11 11 11 11 11 11 11 11 11 11 11 11 11 11 26 11 11 11 11 11 11 11 26 11 11 11 17 12 12 12 12 12 12 12 12 12
12 12 12 12 12 12 12 12 18 11 11 11 11 11 11 11 11 11 11 11 11 11 11 11 11 11 11 11 26 11 11 11 11 11 11 11 26 11 11 11 17 12 12 12 12 12 12 12 12 12
12 12 12 12 12 12 12 12 18 11 11 11 11 11 11 11 11 11 11 11 11 11 11 11 11 11 11 11 26 11 11 11 11 11 11 11 26 26 11 26 17 12 12 12 12 12 12 12 12 12
12 12 12 12 12 12 12 12 18 11 11 11 11 11 11 11 11 11 11 26 26 26 26 26 26 11 11 11 26 26 26 26 26 26 26 26 26 11 11 11 17 12 12 12 12 12 12 12 12 12
12 12 12 12 12 12 12 12 25 16 11 11 11 11 11 11 11 11 11 26 26 26 26 26 26 11 11 11 26 26 26 26 26 26 26 26 11 11 11 11 19 22 12 12 12 12 12 12 12 12
12 12 12 12 12 12 12 12 12 18 11 11 11 11 11 11 11 11 11 26 26 26 26 26 26 11 11 11 26 26 26 26 26 26 26 26 11 11 11 11 11 17 12 12 12 12 12 12 12 12
12 12 12 12 12 12 12 12 12 18 11 11 11 11 11 11 11 11 11 26 26 26 26 26 11 11 11 11 26 26 26 26 26 26 26 26 11 26 11 11 11 17 12 12 12 12 12 12 12 12
12 12 12 12 12 12 12 12 12 18 11 11 11 11 11 11 11 11 11 26 26 26 11 11 11 11 11 11 11 11 26 26 26 26 26 26 11 11 11 11 11 17 12 12 12 12 12 12 12 12
12 12 12 12 12 12 12 12 12 18 11 11 11 11 11 11 11 11 11 26 26 11 11 11 11 11 11 11 11 11 11 26 26 26 26 26 11 11 11 11 11 17 12 12 12 12 12 12 12 12
12 12 12 12 12 12 12 12 12 18 11 11 11 11 11 11 11 11 11 26 26 11 11 11 11 11 11 11 11 11 11 26 26 26 26 11 11 26 11 11 11 17 12 12 12 12 12 12 12 12
12 12 12 12 12 12 12 12 23 21 11 11 11 11 11 11 11 11 11 26 26 11 11 11 11 11 11 11 11 11 11 11 26 26 26 11 11 11 11 11 11 17 12 12 12 12 12 12 12 12
12 12 12 12 12 12 12 12 18 11 11 11 11 11 11 11 11 11 11 26 26 11 11 11 11 11 11 11 11 11 11 11 11 11 11 11 11 11 11 26 11 17 12 12 12 12 12 12 12 12
12 12 12 12 12 12 12 12 18 11 11 11 11 11 11 11 11 14 15 15 15 16 11 11 11 11 11 11 11 11 11 14 15 15 16 11 11 11 11 11 14 24 12 12 12 12 12 12 12 12
12 12 12 12 12 12 12 12 18 11 11 11 11 11 11 11 14 24 12 12 12 25 16 11 11 11 11 11 11 11 14 24 12 12 25 16 11 11 11 11 17 12 12 12 12 12 12 12 12 12
12 12 12 12 12 12 12 12 25 15 15 15 15 15 15 15 24 12 12 12 12 12 25 16 11 11 11 11 11 14 24 12 12 12 12 25 15 16 11 14 24 12 12 12 12 12 12 12 12 12
12 12 12 12 12 12 12 12 12 12 12 12 12 12 12 12 12 12 12 12 12 12 12 25 15 15 15 15 15 24 12 12 12 12 12 12 12 25 15 24 12 12 12 12 12 12 12 12 12 12
12 12 12 12 12 12 12 12 12 12 12 12 12 12 12 12 12 12 12 12 12 12 12 12 12 12 12 12 12 12 12 12 12 12 12 12 12 12 12 12 12 12 12 12 12 12 12 12 12 12
12 12 12 12 12 12 12 12 12 12 12 12 12 12 12 12 12 12 12 12 12 12 12 12 12 12 12 12 12 12 12 12 12 12 12 12 12 12 12 12 12 12 12 12 12 12 12 12 12 12
12 12 12 12 12 12 12 12 12 12 12 12 12 12 12 12 12 12 12 12 12 12 12 12 12 12 12 12 12 12 12 12 12 12 12 12 12 12 12 12 12 12 12 12 12 12 12 12 12 12
12 12 12 12 12 12 12 12 12 12 12 12 12 12 12 12 12 12 12 12 12 12 12 12 12 12 12 12 12 12 12 12 12 12 12 12 12 12 12 12 12 12 12 12 12 12 12 12 12 12
12 12 12 12 12 12 12 12 12 12 12 12 12 12 12 12 12 12 12 12 12 12 12 12 12 12 12 12 12 12 12 12 12 12 12 12 12 12 12 12 12 12 12 12 12 12 12 12 12 12
12 12 12 12 12 12 12 12 12 12 12 12 12 12 12 12 12 12 12 12 12 12 12 12 12 12 12 12 12 12 12 12 12 12 12 12 12 12 12 12 12 12 12 12 12 12 12 12 12 12
12 12 12 12 12 12 12 12 12 12 12 12 12 12 12 12 12 12 12 12 12 12 12 12 12 12 12 12 12 12 12 12 12 12 12 12 12 12 12 12 12 12 12 12 12 12 12 12 12 12
12 12 12 12 12 12 12 12 12 12 12 12 12 12 12 12 12 12 12 12 12 12 12 12 12 12 12 12 12 12 12 12 12 12 12 12 12 12 12 12 12 12 12 12 12 12 12 12 12 12