48 48 48 48 48 48 48 48 48 48 48 48 48 48 48 48 48 48 48 48 48 48 48 48 48 48 48 48 48 48 48 48 48 48 48 48 48 48 48 48 48 48 48 48 48 48 48 48 48 48 
48 48 48 48 48 48 48 48 48 48 48 48 48 48 48 48 48 48 48 48 48 48 48 48 48 48 48 48 48 48 48 48 48 48 48 48 48 48 48 48 48 48 48 48 48 48 48 48 48 48 
48 48 48 48 48 48 48 48 48 48 48 48 48 48 48 48 48 48 48 48 48 48 48 48 48 48 48 48 48 48 48 48 48 48 48 48 48 48 48 48 48 48 48 48 48 48 48 48 48 48 
48 48 48 48 48 48 48 48 48 48 48 48 48 48 48 48 48 48 48 48 48 48 48 48 48 48 48 48 48 48 48 48 48 48 48 48 48 48 48 48 48 48 48 48 48 48 48 48 48 48 
48 48 48 48 48 48 48 48 48 48 48 48 48 48 48 48 48 48 48 48 48 48 48 48 48 48 48 48 48 48 48 48 48 48 48 48 48 48 48 48 48 48 48 48 48 48 48 48 48 48 
48 48 48 48 48 48 48 48 48 9 34 34 34 10 48 48 48 48 9 34 34 34 34 34 34 10 48 48 48 48 48 48 48 9 34 34 34 10 48 48 48 48 48 48 48 48 48 48 48 48 
48 48 48 48 48 48 48 48 9 32 42 20 43 31 34 34 34 34 32 63 63 63 41 20 20 31 34 34 34 10 48 48 9 32 20 41 20 31 34 34 10 48 48 48 48 48 48 48 48 48 
48 48 48 48 48 48 48 9 32 63 20 42 11 12 63 63 63 63 63 63 63 43 41 20 41 20 42 41 20 31 34 34 32 41 42 20 43 20 41 20 31 10 48 48 48 48 48 48 48 48 
48 48 48 48 48 48 9 32 63 63 63 20 31 32 63 63 63 63 63 63 41 20 20 42 11 33 12 20 43 20 63 63 43 1 8 7 8 8 7 8 2 31 10 48 48 48 48 48 48 48 
48 48 48 48 48 48 13 63 63 63 63 20 20 41 20 63 63 63 63 63 20 41 20 11 30 46 29 12 20 41 63 63 42 25 40 40 40 40 40 40 26 20 14 48 48 48 48 48 48 48 
48 48 48 48 48 48 13 63 63 63 42 20 41 41 20 42 20 63 63 63 43 42 20 14 48 48 46 29 12 42 63 63 20 25 40 40 40 40 40 40 26 41 31 10 48 48 48 48 48 48 
48 48 48 48 48 48 13 63 63 43 20 41 63 63 42 41 20 20 63 63 63 20 11 30 44 48 48 9 32 20 63 63 41 5 40 40 40 40 40 40 6 20 43 14 48 48 48 48 48 48 
48 48 48 48 48 48 13 63 63 20 17 18 52 18 19 20 11 12 63 63 63 43 31 10 48 9 34 32 20 41 63 63 20 25 40 40 40 40 40 40 6 41 42 14 48 48 48 48 48 48 
48 48 48 48 48 48 29 12 43 41 37 38 38 38 39 42 14 29 12 63 63 20 20 31 34 32 20 11 12 20 63 63 63 21 28 27 28 28 27 27 22 43 63 14 48 48 48 48 48 48 
48 48 48 48 48 48 9 32 20 42 37 38 38 38 39 20 31 10 13 63 63 42 20 42 41 20 20 31 32 20 63 63 63 63 63 63 1 2 63 63 63 63 63 31 10 48 48 48 48 48 
48 48 48 48 48 48 13 41 41 63 37 38 38 38 39 41 20 31 32 63 63 20 41 1 7 8 8 2 42 20 42 43 63 63 63 63 5 26 63 63 63 63 63 63 14 48 48 48 48 48 
48 48 48 48 48 48 13 20 20 41 57 58 53 58 59 41 20 43 63 63 63 43 20 25 40 40 40 6 41 20 20 42 63 63 63 63 25 6 63 63 63 63 63 63 14 48 48 48 48 48 
48 48 48 48 48 48 29 12 42 41 20 21 27 22 63 20 41 63 63 63 63 20 42 5 40 40 40 6 43 41 20 20 63 63 63 63 25 6 63 63 63 63 63 20 14 48 48 48 48 48 
48 48 48 48 48 48 48 13 20 20 42 1 2 41 20 20 20 63 63 63 63 63 42 21 4 40 3 22 20 20 42 63 63 63 63 63 5 26 63 63 63 63 63 11 30 48 48 48 48 48 
48 48 48 48 48 48 48 13 63 20 1 24 6 20 41 20 63 63 63 63 63 63 63 63 5 40 6 63 63 63 63 63 63 63 63 63 25 26 63 63 63 63 20 14 48 48 48 48 48 48 
48 48 48 48 48 48 48 13 63 43 5 3 22 63 63 63 63 63 63 63 63 63 63 63 25 40 6 63 63 63 63 63 63 63 63 63 5 6 63 63 63 63 11 30 48 48 48 48 48 48 
48 48 48 48 48 48 48 13 63 63 5 26 63 63 63 63 63 63 63 63 63 63 63 63 25 40 26 63 63 63 63 63 63 63 63 63 5 26 63 63 63 63 14 48 48 48 48 48 48 48 
48 48 48 48 48 48 48 13 63 63 5 26 63 63 63 63 63 42 41 20 63 63 63 43 25 40 6 20 63 63 63 63 63 63 63 63 25 6 63 63 63 63 14 48 48 48 48 48 48 48 
48 48 48 48 48 48 48 13 63 63 5 26 63 63 63 63 43 41 20 43 41 63 41 20 5 40 6 41 42 63 63 63 63 63 63 63 21 22 63 63 63 20 14 48 48 48 48 48 48 48 
48 48 48 48 48 48 48 13 63 63 5 26 63 63 63 1 8 7 8 7 8 7 8 7 24 40 23 7 7 8 7 7 8 7 7 8 8 8 7 2 41 11 30 48 48 48 48 48 48 48 
48 48 48 48 48 48 48 13 63 20 5 26 63 63 63 5 40 40 40 40 40 40 40 40 40 40 40 40 40 40 40 40 40 40 40 40 40 40 40 6 20 14 48 48 48 48 48 48 48 48 
48 48 48 48 48 48 48 13 63 41 5 26 63 63 63 21 27 27 28 27 28 27 28 27 4 40 3 27 27 28 27 28 27 27 28 28 27 28 27 22 41 31 10 48 48 48 48 48 48 48 
48 48 48 48 48 48 48 13 63 1 24 26 63 63 63 63 63 63 43 63 63 63 43 20 25 40 26 41 43 63 63 63 63 63 63 63 63 63 20 20 20 43 31 10 48 48 48 48 48 48 
48 48 48 48 48 48 48 13 43 25 3 22 63 63 63 63 63 63 20 63 63 63 63 41 25 40 6 20 63 63 63 63 63 63 63 63 63 63 63 43 41 20 42 31 10 48 48 48 48 48 
48 48 48 48 48 48 48 13 41 21 22 63 63 63 63 63 63 63 42 63 63 63 63 63 5 40 26 63 63 63 63 63 63 63 63 63 63 63 63 20 20 20 20 63 14 48 48 48 48 48 
48 48 48 48 48 48 48 13 63 42 63 63 63 63 63 63 63 63 43 63 63 63 63 63 25 40 6 63 63 63 63 20 41 20 41 43 63 63 63 41 20 43 63 63 14 48 48 48 48 48 
48 48 48 48 48 48 48 13 63 60 63 63 42 20 41 20 43 20 43 63 63 63 63 63 25 40 26 63 63 63 20 17 18 18 18 19 20 63 63 20 20 42 63 63 14 48 48 48 48 48 
48 48 48 48 48 48 48 13 63 61 63 63 20 63 63 63 63 63 63 63 63 63 63 63 5 40 6 63 63 63 41 37 38 38 38 39 42 63 63 63 20 63 63 63 14 48 48 48 48 48 
48 48 48 48 48 48 48 13 63 62 63 63 41 63 63 63 63 63 63 63 63 63 63 63 25 40 26 63 63 63 43 37 38 38 38 39 20 63 63 20 20 41 63 63 14 48 48 48 48 48 
48 48 48 48 48 48 48 13 63 43 20 41 20 63 63 63 63 63 63 63 63 63 63 63 25 40 6 63 63 63 63 57 58 53 58 59 43 63 63 20 41 20 63 11 30 48 48 48 48 48 
48 48 48 48 48 48 48 13 63 63 63 63 20 63 63 63 20 43 63 63 63 63 20 42 5 40 26 20 20 63 63 41 21 27 22 20 63 63 20 41 41 20 63 14 48 48 48 48 48 48 
48 48 48 48 48 48 48 29 12 63 63 63 41 63 63 63 42 20 41 63 63 43 20 41 21 27 22 41 20 20 63 63 63 60 63 63 63 20 42 43 1 2 20 14 48 48 48 48 48 48 
48 48 48 48 48 48 48 9 32 63 63 63 43 20 41 20 41 20 43 63 63 20 41 20 1 7 2 41 43 42 20 63 63 61 63 63 20 20 63 20 21 22 20 14 48 48 48 48 48 48 
48 48 48 48 48 48 48 13 63 63 63 63 63 63 63 63 1 7 2 63 63 41 20 1 24 40 23 2 20 41 20 63 63 62 63 63 20 20 1 8 2 20 41 31 10 48 48 48 48 48 
48 48 48 48 48 48 48 13 63 63 63 63 63 63 63 63 5 40 26 63 63 20 43 25 40 40 40 26 20 42 20 41 20 42 41 20 1 7 24 40 6 42 20 20 14 48 48 48 48 48 
48 48 48 48 48 48 48 13 63 63 63 63 63 63 63 63 21 28 22 63 63 20 41 21 4 40 3 42 20 43 20 41 41 20 20 42 25 40 40 3 22 63 20 41 14 48 48 48 48 48 
48 48 48 48 48 48 48 13 63 63 63 63 63 63 63 63 43 11 33 33 12 20 20 42 41 28 22 20 20 20 11 33 33 33 12 20 21 27 28 22 43 41 20 20 14 48 48 48 48 48 
48 48 48 48 48 48 48 29 12 63 63 63 63 63 63 63 11 30 48 48 29 33 12 20 20 43 20 20 11 33 30 48 48 48 13 41 20 63 20 20 20 20 20 11 30 48 48 48 48 48 
48 48 48 48 48 48 48 48 29 33 12 63 63 63 63 11 30 48 48 48 48 48 29 33 33 33 33 33 30 48 48 48 48 48 29 12 20 20 20 41 63 20 11 30 48 48 48 48 48 48 
48 48 48 48 48 48 48 48 48 48 29 33 33 33 33 30 48 48 48 48 48 48 48 48 48 48 48 48 48 48 48 48 48 48 48 29 33 33 33 33 33 33 30 48 48 48 48 48 48 48 
48 48 48 48 48 48 48 48 48 48 48 48 48 48 48 48 48 48 48 48 48 48 48 48 48 48 48 48 48 48 48 48 48 48 48 48 48 48 48 48 48 48 48 48 48 48 48 48 48 48 
48 48 48 48 48 48 48 48 48 48 48 48 48 48 48 48 48 48 48 48 48 48 48 48 48 48 48 48 48 48 48 48 48 48 48 48 48 48 48 48 48 48 48 48 48 48 48 48 48 48 
48 48 48 48 48 48 48 48 48 48 48 48 48 48 48 48 48 48 48 48 48 48 48 48 48 48 48 48 48 48 48 48 48 48 48 48 48 48 48 48 48 48 48 48 48 48 48 48 48 48 
48 48 48 48 48 48 48 48 48 48 48 48 48 48 48 48 48 48 48 48 48 48 48 48 48 48 48 48 48 48 48 48 48 48 48 48 48 48 48 48 48 48 48 48 48 48 48 48 48 48 
48 48 48 48 48 48 48 48 48 48 48 48 48 48 48 48 48 48 48 48 48 48 48 48 48 48 48 48 48 48 48 48 48 48 48 48 48 48 48 48 48 48 48 48 48 48 48 48 48 48 
